1111111111111111111
1000C00000000000011
10010001C0000000101
1001010001000010011
1000001000100010001
10010G0000000100001
10000000C0001000001
100000C000010000001
1001000000100E00001
10011111C0000000001
10010010000010P0001
1111111111111111111
