11111111111111111111111111111111
1000C000000000000000000000000011
100111111100000010001C0000000101
10010000001000001010001000001001
10010000001000001000000100010001
10010000001000000000000000100001
100100000100010000000C0001000001
10011111100000000000000010000001
10010000000000000000000100000001
10010000000000000000000000C00001
10010000000000000100010000000001
1001000C000000000010100000000001
110000100001110000001000000C0001
10000110000001000000010000000001
10001010000110000000001E00000E01
10011111C01000000000000100000001
100000100011110100000000010P0001
10000000000000000000000000000001
11111111111111111111111111111111
